"","overall","MissingResponseSchema","InvalidSchemaType","MultipleResponses","InvalidSchemaTypeScalar","numOps","numOpsCreated"
"1Forge Finance APIs","1","1","0","0","0","2","1"
"Authentiq","6","3","0","3","0","14","11"
"Afterbanks","0","0","0","0","0","3","3"
"airportsapi","0","0","0","0","0","1","1"
"AWS Certificate Manager","4","4","0","0","0","10","6"
"Alexa For Business","19","0","19","0","0","36","36"
"Amazon API Gateway","71","25","46","0","0","98","73"
"Application Auto Scaling","5","0","5","0","0","10","10"
"Amazon AppStream","10","0","10","0","0","32","32"
"AWS AppSync","21","0","21","0","0","26","26"
"Amazon Athena","2","0","2","0","0","11","11"
"Auto Scaling","29","20","9","0","0","52","32"
"AWS Migration Hub","10","0","10","0","0","16","16"
"AWS Batch","5","0","5","0","0","16","16"
"AWS Budgets","9","0","9","0","0","13","13"
"AWS Cost Explorer Service","0","0","0","0","0","4","4"
"AWS Cloud9","3","0","3","0","0","10","10"
"Amazon CloudDirectory","26","1","25","0","0","62","61"
"AWS CloudFormation","9","4","5","0","0","41","37"
"Amazon CloudFront","27","27","0","0","0","27","0"
"Amazon CloudFront_1","28","28","0","0","0","28","0"
"Amazon CloudHSM","1","0","1","0","0","20","20"
"AWS CloudHSM V2","2","0","2","0","0","10","10"
"Amazon CloudSearch","0","0","0","0","0","22","22"
"Amazon CloudSearch_1","0","0","0","0","0","24","24"
"Amazon CloudSearch Domain","2","0","2","0","0","3","3"
"AWS CloudTrail","5","0","5","0","0","14","14"
"AWS CodeBuild","4","0","4","0","0","15","15"
"AWS CodeCommit","4","4","0","0","0","35","31"
"AWS CodeDeploy","10","10","0","0","0","40","30"
"AWS CodePipeline","8","8","0","0","0","27","19"
"AWS CodeStar","3","0","3","0","0","18","18"
"Amazon Cognito Identity","4","4","0","0","0","18","14"
"Amazon Cognito Identity Provider","38","11","27","0","0","94","83"
"Amazon Cognito Sync","16","1","15","0","0","17","16"
"Amazon Comprehend","0","0","0","0","0","11","11"
"AWS Config","10","8","2","0","0","27","19"
"AWS Cost and Usage Report Service","1","0","1","0","0","3","3"
"AWS Data Pipeline","7","2","5","0","0","19","17"
"Amazon DynamoDB Accelerator (DAX)","0","0","0","0","0","21","21"
"AWS Device Farm","7","0","7","0","0","49","49"
"AWS Direct Connect","2","0","2","0","0","44","44"
"AWS Application Discovery Service","7","0","7","0","0","19","19"
"AWS Database Migration Service","4","0","4","0","0","42","42"
"AWS Directory Service","18","0","18","0","0","40","40"
"Amazon DynamoDB","0","0","0","0","0","13","13"
"Amazon DynamoDB_1","3","2","1","0","0","29","27"
"Amazon Elastic Compute Cloud","61","61","0","0","0","266","205"
"Amazon EC2 Container Registry","0","0","0","0","0","22","22"
"Amazon EC2 Container Service","0","0","0","0","0","31","31"
"Amazon ElastiCache","3","3","0","0","0","40","37"
"AWS Elastic Beanstalk","10","10","0","0","0","43","33"
"Amazon Elastic File System","9","5","4","0","0","11","6"
"Elastic Load Balancing","12","0","12","0","0","29","29"
"Elastic Load Balancing_1","9","0","9","0","0","34","34"
"Amazon Elastic MapReduce","9","5","4","0","0","27","22"
"Amazon Elastic Transcoder","13","0","13","0","0","17","17"
"Amazon Simple Email Service","41","8","33","0","0","70","62"
"AWS Marketplace Entitlement Service","0","0","0","0","0","1","1"
"Amazon Elasticsearch Service","10","3","7","0","0","14","11"
"Amazon CloudWatch Events","6","5","1","0","0","15","10"
"Amazon Kinesis Firehose","2","0","2","0","0","7","7"
"Amazon GameLift","12","4","8","0","0","64","60"
"Amazon Glacier","37","12","25","0","0","33","21"
"AWS Glue","29","0","29","0","0","75","75"
"AWS Greengrass","60","0","60","0","0","74","74"
"Amazon GuardDuty","27","0","27","0","0","37","37"
"AWS Health APIs and Notifications","0","0","0","0","0","6","6"
"AWS Identity and Access Management","54","52","2","0","0","122","70"
"AWS Import/Export","0","0","0","0","0","6","6"
"Amazon Inspector","9","9","0","0","0","33","24"
"AWS IoT Data Plane","3","1","2","0","0","4","3"
"AWS IoT Jobs Data Plane","2","0","2","0","0","4","4"
"AWS IoT","102","17","85","0","0","114","97"
"Amazon Kinesis Video Streams Archived Media","0","0","0","0","0","2","2"
"Amazon Kinesis Video Streams Media","0","0","0","0","0","1","1"
"Amazon Kinesis","11","10","1","0","0","22","12"
"Amazon Kinesis Video Streams","5","0","5","0","0","10","10"
"AWS Key Management Service","15","14","1","0","0","35","21"
"AWS Lambda","9","2","7","0","0","11","9"
"AWS Lambda_1","19","6","13","0","0","30","24"
"Amazon Lex Model Building Service","27","9","18","0","0","34","25"
"Amazon Lightsail","4","0","4","0","0","71","71"
"Amazon CloudWatch Logs","18","18","0","0","0","33","15"
"Amazon Machine Learning","0","0","0","0","0","28","28"
"AWS Marketplace Commerce Analytics","0","0","0","0","0","2","2"
"AWS Elemental MediaConvert","16","0","16","0","0","20","20"
"AWS Elemental MediaLive","33","0","33","0","0","14","14"
"AWS Elemental MediaPackage","9","0","9","0","0","11","11"
"AWS Elemental MediaStore Data Plane","6","0","6","0","0","5","5"
"AWS Elemental MediaStore","3","0","3","0","0","7","7"
"AWSMarketplace Metering","0","0","0","0","0","3","3"
"AWS Mobile","7","0","7","0","0","9","9"
"Amazon Mobile Analytics","1","1","0","0","0","1","0"
"Amazon CloudWatch","7","6","1","0","0","15","9"
"AmazonMQ","15","0","15","0","0","17","17"
"Amazon Mechanical Turk","18","0","18","0","0","39","39"
"AWS OpsWorks","38","38","0","0","0","73","35"
"AWS OpsWorks for Chef Automate","4","0","4","0","0","15","15"
"AWS Organizations","11","10","1","0","0","42","32"
"Amazon Polly","6","0","6","0","0","6","6"
"AWS Price List Service","0","0","0","0","0","3","3"
"Amazon Relational Database Service","10","9","1","0","0","91","82"
"Amazon Redshift","9","9","0","0","0","63","54"
"Amazon Rekognition","3","0","3","0","0","33","33"
"AWS Resource Groups","6","0","6","0","0","11","11"
"AWS Resource Groups Tagging API","0","0","0","0","0","5","5"
"Amazon Route 53 Domains","4","0","4","0","0","24","24"
"Amazon Lex Runtime Service","0","0","0","0","0","2","2"
"Amazon SageMaker Runtime","0","0","0","0","0","1","1"
"Amazon SageMaker Service","9","7","2","0","0","29","22"
"Amazon SimpleDB","6","6","0","0","0","10","4"
"AWSServerlessApplicationRepository","4","0","4","0","0","8","8"
"AWS Service Catalog","14","0","14","0","0","53","53"
"Amazon Route 53 Auto Naming","1","0","1","0","0","17","17"
"AWS Shield","7","0","7","0","0","10","10"
"AWS Server Migration Service","7","0","7","0","0","11","11"
"Amazon Import/Export Snowball","5","0","5","0","0","17","17"
"Amazon Simple Notification Service","12","10","2","0","0","30","20"
"Amazon Simple Queue Service","9","9","0","0","0","20","11"
"Amazon Simple Systems Manager (SSM)","16","0","16","0","0","97","97"
"AWS Step Functions","5","0","5","0","0","19","19"
"AWS Storage Gateway","0","0","0","0","0","63","63"
"Amazon DynamoDB Streams","0","0","0","0","0","4","4"
"AWS Security Token Service","1","0","1","0","0","7","7"
"AWS Support","0","0","0","0","0","14","14"
"Amazon Simple Workflow Service","13","13","0","0","0","31","18"
"Amazon Translate","0","0","0","0","0","1","1"
"AWS WAF Regional","3","0","3","0","0","70","70"
"AWS WAF","1","0","1","0","0","66","66"
"Amazon WorkDocs","32","10","22","0","0","36","26"
"Amazon WorkMail","14","0","14","0","0","28","28"
"Amazon WorkSpaces","3","0","3","0","0","14","14"
"AWS X-Ray","1","0","1","0","0","6","6"
"APIMATIC API Transformer","1","0","1","0","0","1","1"
"APIs.guru","0","0","0","0","0","2","2"
"2ch matome feeds APIs","0","0","0","0","0","1","1"
"Certificate feeds APIs","0","0","0","0","0","1","1"
"Cosine Similarity","4","0","0","4","0","2","2"
"Design feeds APIs","0","0","0","0","0","1","1"
"Document frequency APIs","0","0","0","0","0","1","1"
"Game feeds APIs","0","0","0","0","0","1","1"
"Japanese WordNet APIs","0","0","0","0","0","1","1"
"Kmeans clustering by word2vec","2","0","0","2","0","1","1"
"Kuromoji APIs","4","0","0","4","0","4","4"
"Language Detection APIs","0","0","0","0","0","2","2"
"News feeds APIs","0","0","0","0","0","1","1"
"Pioneer blog feeds APIs","0","0","0","0","0","1","1"
"RSS2JSON APIs","0","0","0","0","0","1","1"
"SentencePiece APIs (tweet)","0","0","0","0","0","1","1"
"SentencePiece APIs (wikipedia)","0","0","0","0","0","2","2"
"Sentence separator APIs","0","0","0","0","0","1","1"
"Sentence Similarity","2","0","0","2","0","1","1"
"Sentiment APIs","0","0","0","0","0","1","1"
"Sentiment APIs_1","2","0","0","2","0","1","1"
"Synonym APIs","0","0","0","0","0","1","1"
"Tech feeds APIs","0","0","0","0","0","1","1"
"Text2Label by tfidf APIs","0","0","0","0","0","1","1"
"Text2Label by word vector APIs","0","0","0","0","0","1","1"
"Travel feeds APIs","0","0","0","0","0","1","1"
"Tweet summarization APIs","0","0","0","0","0","1","1"
"Twitter APIs","0","0","0","0","0","3","3"
"Twitter APIs with sentiment by Apitore sentiment","0","0","0","0","0","1","1"
"Twitter APIs with Word2Vec query expansion, and add sentiment by Apitore sentiment","0","0","0","0","0","1","1"
"Twitter APIs with Word2Vec query expansion","0","0","0","0","0","1","1"
"Url2Href APIs","0","0","0","0","0","1","1"
"Url2Html APIs","0","0","0","0","0","1","1"
"Url2Label by tfidf APIs","0","0","0","0","0","1","1"
"Url2Label by word vector APIs","0","0","0","0","0","1","1"
"Url2Src APIs","0","0","0","0","0","1","1"
"Url2Text APIs","0","0","0","0","0","1","1"
"Word2Vec APIs","0","0","0","0","0","5","5"
"WordNet APIs","0","0","0","0","0","8","8"
"WordNet hypernym APIs","0","0","0","0","0","1","1"
"WordNet hyponym APIs","0","0","0","0","0","1","1"
"WordNet Similarity APIs","0","0","0","0","0","8","8"
"WordNet synonym APIs","0","0","0","0","0","1","1"
"WordNet translation APIs","0","0","0","0","0","1","1"
"Words to Vectors APIs","0","0","0","0","0","1","1"
"ART19 Content","22","22","0","0","0","22","0"
"Auckland Museum","6","6","0","0","0","6","0"
"Authentiq Connect","4","4","0","0","0","9","5"
"Avaza","5","2","3","0","0","40","38"
"AdvisorManagementClient","4","3","0","1","0","9","6"
"AdvisorManagementClient_1","4","3","0","1","0","9","6"
"AdvisorManagementClient_1_1","6","5","0","1","0","13","8"
"AzureAnalysisServices","12","4","0","8","0","12","8"
"AzureAnalysisServices_1","13","5","0","8","0","14","9"
"AzureAnalysisServices_1_1","13","5","0","8","0","15","10"
"ApiManagementClient","15","10","1","4","0","15","5"
"ApiManagementClient_1","17","5","2","10","0","21","16"
"ApiManagementClient_1_1","3","2","0","1","0","4","2"
"ApiManagementClient_1_1_1","3","1","0","2","0","4","3"
"ApiManagementClient_1_1_1_1","3","2","0","1","0","4","2"
"ApiManagementClient_1_1_1_1_1","3","1","0","2","0","4","3"
"ApiManagementClient_1_1_1_1_1_1","3","2","0","1","0","4","2"
"ApiManagementClient_1_1_1_1_1_1_1","3","1","0","2","0","4","3"
"ApiManagementClient_1_1_1_1_1_1_1_1","10","1","0","9","0","12","11"
"ApiManagementClient_1_1_1_1_1_1_1_1_1","14","1","0","13","0","14","13"
"ApiManagementClient_1_1_1_1_1_1_1_1_1_1","13","1","1","11","0","13","12"
"ApiManagementClient_1_1_1_1_1_1_1_1_1_1_1","3","1","0","2","0","4","3"
"ApiManagementClient_1_1_1_1_1_1_1_1_1_1_1_1","7","4","1","2","0","7","3"
"ApiManagementClient_1_1_1_1_1_1_1_1_1_1_1_1_1","8","2","2","4","0","7","5"
"ApiManagementClient_1_1_1_1_1_1_1_1_1_1_1_1_1_1","3","2","0","1","0","4","2"
"ApiManagementClient_1_1_1_1_1_1_1_1_1_1_1_1_1_1_1","3","1","0","2","0","4","3"
"ApiManagementClient_1_1_1_1_1_1_1_1_1_1_1_1_1_1_1_1","3","2","0","1","0","4","2"
"ApiManagementClient_1_1_1_1_1_1_1_1_1_1_1_1_1_1_1_1_1","3","1","0","2","0","4","3"
"ApiManagementClient_1_1_1_1_1_1_1_1_1_1_1_1_1_1_1_1_1_1","0","0","0","0","0","1","1"
"ApiManagementClient_1_1_1_1_1_1_1_1_1_1_1_1_1_1_1_1_1_1_1","0","0","0","0","0","2","2"
"ApiManagementClient_1_1_1_1_1_1_1_1_1_1_1_1_1_1_1_1_1_1_1_1","3","2","0","1","0","4","2"
"ApiManagementClient_1_1_1_1_1_1_1_1_1_1_1_1_1_1_1_1_1_1_1_1_1","3","1","0","2","0","4","3"
"ApiManagementClient_1_1_1_1_1_1_1_1_1_1_1_1_1_1_1_1_1_1_1_1_1_1","16","9","3","4","0","14","5"
"ApiManagementClient_1_1_1_1_1_1_1_1_1_1_1_1_1_1_1_1_1_1_1_1_1_1_1","18","4","6","8","0","15","11"
"ApiManagementClient_1_1_1_1_1_1_1_1_1_1_1_1_1_1_1_1_1_1_1_1_1_1_1_1","3","2","0","1","0","4","2"
"ApiManagementClient_1_1_1_1_1_1_1_1_1_1_1_1_1_1_1_1_1_1_1_1_1_1_1_1_1","3","1","0","2","0","4","3"
"ApiManagementClient_1_1_1_1_1_1_1_1_1_1_1_1_1_1_1_1_1_1_1_1_1_1_1_1_1_1","0","0","0","0","0","2","2"
"ApiManagementClient_1_1_1_1_1_1_1_1_1_1_1_1_1_1_1_1_1_1_1_1_1_1_1_1_1_1_1","0","0","0","0","0","2","2"
"ApiManagementClient_1_1_1_1_1_1_1_1_1_1_1_1_1_1_1_1_1_1_1_1_1_1_1_1_1_1_1_1","0","0","0","0","0","1","1"
"ApiManagementClient_1_1_1_1_1_1_1_1_1_1_1_1_1_1_1_1_1_1_1_1_1_1_1_1_1_1_1_1_1","0","0","0","0","0","8","8"
"ApiManagementClient_1_1_1_1_1_1_1_1_1_1_1_1_1_1_1_1_1_1_1_1_1_1_1_1_1_1_1_1_1_1","5","4","0","1","0","6","2"
"ApiManagementClient_1_1_1_1_1_1_1_1_1_1_1_1_1_1_1_1_1_1_1_1_1_1_1_1_1_1_1_1_1_1_1","5","3","0","2","0","6","3"
"ApiManagementClient_1_1_1_1_1_1_1_1_1_1_1_1_1_1_1_1_1_1_1_1_1_1_1_1_1_1_1_1_1_1_1_1","9","7","1","1","0","13","6"
"ApiManagementClient_1_1_1_1_1_1_1_1_1_1_1_1_1_1_1_1_1_1_1_1_1_1_1_1_1_1_1_1_1_1_1_1_1","11","4","1","6","0","10","6"
"ApiManagementClient_1_1_1_1_1_1_1_1_1_1_1_1_1_1_1_1_1_1_1_1_1_1_1_1_1_1_1_1_1_1_1_1_1_1","5","2","2","1","0","9","7"
"ApiManagementClient_1_1_1_1_1_1_1_1_1_1_1_1_1_1_1_1_1_1_1_1_1_1_1_1_1_1_1_1_1_1_1_1_1_1_1","5","1","2","2","0","9","8"
"ApiManagementClient_1_1_1_1_1_1_1_1_1_1_1_1_1_1_1_1_1_1_1_1_1_1_1_1_1_1_1_1_1_1_1_1_1_1_1_1","54","38","0","16","0","84","46"
"ApiManagementClient_1_1_1_1_1_1_1_1_1_1_1_1_1_1_1_1_1_1_1_1_1_1_1_1_1_1_1_1_1_1_1_1_1_1_1_1_1","0","0","0","0","0","2","2"
"ApiManagementClient_1_1_1_1_1_1_1_1_1_1_1_1_1_1_1_1_1_1_1_1_1_1_1_1_1_1_1_1_1_1_1_1_1_1_1_1_1_1","3","1","0","2","0","6","5"
"ApplicationInsightsManagementClient","0","0","0","0","0","1","1"
"ApplicationInsightsManagementClient_1","0","0","0","0","0","4","4"
"ApplicationInsightsManagementClient_1_1","0","0","0","0","0","5","5"
"ApplicationInsightsManagementClient_1_1_1","0","0","0","0","0","3","3"
"ApplicationInsightsManagementClient_1_1_1_1","4","1","2","1","0","5","4"
"ApplicationInsightsManagementClient_1_1_1_1_1","4","1","2","1","0","5","4"
"AuthorizationManagementClient","0","0","0","0","0","10","10"
"AuthorizationManagementClient_1","1","0","1","0","0","10","10"
"BatchAI","15","4","1","10","0","20","16"
"BillingClient","0","0","0","0","0","4","4"
"BillingManagementClient","0","0","0","0","0","6","6"
"CdnManagementClient","18","5","0","13","0","25","20"
"CdnManagementClient_1","18","5","0","13","0","25","20"
"CdnManagementClient_1_1","18","7","0","11","0","30","23"
"CdnManagementClient_1_1_1","24","7","0","17","0","31","24"
"CognitiveServicesManagementClient","5","1","1","3","0","8","7"
"CognitiveServicesManagementClient_1","6","1","2","3","0","10","9"
"ContainerServiceClient","4","1","0","3","0","4","3"
"ContainerServiceClient_1","4","1","0","3","0","5","4"
"ContainerServiceClient_1_1","4","1","0","3","0","5","4"
"ContainerServiceClient_1_1_1","4","1","0","3","0","5","4"
"DiskResourceProviderClient","16","0","0","16","0","14","14"
"DiskResourceProviderClient_1","16","0","0","16","0","14","14"
"RunCommandsClient","2","0","0","2","0","3","3"
"ComputeManagementClient","0","0","0","0","0","1","1"
"ComputeManagementClient_1","52","0","0","52","0","54","54"
"ComputeManagementClient_1_1","52","0","0","52","0","54","54"
"ComputeManagementClient_1_1_1","62","0","0","62","0","62","62"
"ComputeManagementClient_1_1_1_1","72","0","0","72","0","72","72"
"ComputeManagementClient_1_1_1_1_1","72","0","0","72","0","71","71"
"ConsumptionManagementClient","0","0","0","0","0","2","2"
"ConsumptionManagementClient_1","0","0","0","0","0","4","4"
"ConsumptionManagementClient_1_1","3","1","0","2","0","5","4"
"ContainerServiceClient_1_1_1_1","4","1","0","3","0","5","4"
"ContainerServiceClient_1_1_1_1_1","0","0","0","0","0","1","1"
"ContainerServiceClient_1_1_1_1_1_1","4","1","0","3","0","7","6"
"Cosmos DB","7","4","0","3","0","23","19"
"CustomerInsightsManagementClient","42","11","0","31","0","58","47"
"CustomerInsightsManagementClient_1","47","13","0","34","0","65","52"
"Azure Data Catalog Resource Provider","4","1","0","3","0","5","4"
"DataLakeAnalyticsAccountManagementClient","8","5","0","3","0","16","11"
"DataLakeAnalyticsAccountManagementClient_1","12","7","0","5","0","27","20"
"DataLakeStoreAccountManagementClient","7","3","0","4","0","10","7"
"DataLakeStoreAccountManagementClient_1","9","4","0","5","0","17","13"
"Azure Data Migration Service Resource Provider","18","5","2","11","0","23","18"
"DevTestLabsClient","49","15","3","31","0","51","36"
"DevTestLabsClient_1","99","32","2","65","0","96","64"
"DnsManagementClient","6","2","0","4","0","10","8"
"DnsManagementClient_1","8","1","0","7","0","10","9"
"DnsManagementClient_1_1","8","2","0","6","0","10","8"
"Domain Services Resource Provider","4","0","0","4","0","6","6"
"Domain Services Resource Provider_1","4","0","0","4","0","6","6"
"EventGridManagementClient","5","2","1","2","0","25","23"
"EventGridManagementClient_1","5","2","1","2","0","25","23"
"EventHubManagementClient","14","5","0","9","0","27","22"
"EventHubManagementClient_1","19","8","0","11","0","37","29"
"HDInsightManagementClient","2","1","1","0","0","4","3"
"HDInsightManagementClient_1","0","0","0","0","0","1","1"
"HDInsightManagementClient_1_1","6","2","2","2","0","6","4"
"HDInsightManagementClient_1_1_1","2","1","0","1","0","2","1"
"HDInsightManagementClient_1_1_1_1","4","4","0","0","0","6","2"
"HDInsightManagementClient_1_1_1_1_1","0","0","0","0","0","1","1"
"HDInsightManagementClient_1_1_1_1_1_1","4","3","0","1","0","6","3"
"IntuneResourceManagementClient","20","10","0","10","0","31","21"
"IntuneResourceManagementClient_1","20","10","0","10","0","31","21"
"iotHubClient","5","1","0","4","0","19","18"
"iotHubClient_1","5","1","0","4","0","19","18"
"iotHubClient_1_1","9","2","0","7","0","26","24"
"KeyVaultManagementClient","3","1","0","2","0","5","4"
"KeyVaultManagementClient_1","5","2","0","3","0","8","6"
"Azure Location Based Services Resource Provider","5","2","0","3","0","9","7"
"LogicManagementClient","14","7","1","6","0","26","19"
"LogicManagementClient_1","24","6","0","18","0","26","20"
"LogicManagementClient_1_1","41","15","2","24","0","57","42"
"Azure ML Commitment Plans Management Client","3","1","0","2","0","9","8"
"Azure ML Web Services Management Client","4","1","0","3","0","6","5"
"Azure ML Web Services Management Client_1","6","1","0","5","0","7","6"
"Machine Learning Workspaces Management Client","3","2","0","1","0","8","6"
"Azure Machine Learning Compute Management Client","10","1","0","9","0","9","8"
"Machine Learning Compute Management Client","6","1","0","5","0","9","8"
"ML Team Account Management Client","12","3","0","9","0","14","11"
"MarketplaceOrdering.Agreements","0","0","0","0","0","3","3"
"MediaServicesManagementClient","3","2","0","1","0","9","7"
"Engagement.ManagementClient","9","1","6","2","0","37","36"
"ManagedServiceIdentityClient","4","1","0","3","0","6","5"
"MySQLManagementClient","18","4","0","14","0","25","21"
"NetworkManagementClient","12","3","2","7","0","8","5"
"NetworkManagementClient_1","12","3","2","7","0","8","5"
"NetworkManagementClient_1_1","12","3","2","7","0","9","6"
"NetworkManagementClient_1_1_1","4","1","0","3","0","5","4"
"NetworkManagementClient_1_1_1_1","4","1","0","3","0","5","4"
"NetworkManagementClient_1_1_1_1_1","0","0","0","0","0","1","1"
"NetworkManagementClient_1_1_1_1_1_1","0","0","0","0","0","1","1"
"NetworkManagementClient_1_1_1_1_1_1_1","0","0","0","0","0","1","1"
"NetworkManagementClient_1_1_1_1_1_1_1_1","0","0","0","0","0","1","1"
"NetworkManagementClient_1_1_1_1_1_1_1_1_1","0","0","0","0","0","1","1"
"NetworkManagementClient_1_1_1_1_1_1_1_1_1_1","0","0","0","0","0","1","1"
"NetworkManagementClient_1_1_1_1_1_1_1_1_1_1_1","0","0","0","0","0","1","1"
"NetworkManagementClient_1_1_1_1_1_1_1_1_1_1_1_1","0","0","0","0","0","1","1"
"NetworkManagementClient_1_1_1_1_1_1_1_1_1_1_1_1_1","0","0","0","0","0","1","1"
"NetworkManagementClient_1_1_1_1_1_1_1_1_1_1_1_1_1_1","0","0","0","0","0","1","1"
"NetworkManagementClient_1_1_1_1_1_1_1_1_1_1_1_1_1_1_1","0","0","0","0","0","1","1"
"NetworkManagementClient_1_1_1_1_1_1_1_1_1_1_1_1_1_1_1_1","0","0","0","0","0","1","1"
"NetworkManagementClient_1_1_1_1_1_1_1_1_1_1_1_1_1_1_1_1_1","12","3","0","9","0","17","14"
"NetworkManagementClient_1_1_1_1_1_1_1_1_1_1_1_1_1_1_1_1_1_1","18","3","0","15","0","19","16"
"NetworkManagementClient_1_1_1_1_1_1_1_1_1_1_1_1_1_1_1_1_1_1_1","20","3","2","15","0","19","16"
"NetworkManagementClient_1_1_1_1_1_1_1_1_1_1_1_1_1_1_1_1_1_1_1_1","25","3","1","21","0","19","16"
"NetworkManagementClient_1_1_1_1_1_1_1_1_1_1_1_1_1_1_1_1_1_1_1_1_1","25","3","1","21","0","19","16"
"NetworkManagementClient_1_1_1_1_1_1_1_1_1_1_1_1_1_1_1_1_1_1_1_1_1_1","27","3","1","23","0","20","17"
"NetworkManagementClient_1_1_1_1_1_1_1_1_1_1_1_1_1_1_1_1_1_1_1_1_1_1_1","27","3","1","23","0","20","17"
"NetworkManagementClient_1_1_1_1_1_1_1_1_1_1_1_1_1_1_1_1_1_1_1_1_1_1_1_1","27","3","1","23","0","20","17"
"NetworkManagementClient_1_1_1_1_1_1_1_1_1_1_1_1_1_1_1_1_1_1_1_1_1_1_1_1_1","31","3","1","27","0","22","19"
"NetworkManagementClient_1_1_1_1_1_1_1_1_1_1_1_1_1_1_1_1_1_1_1_1_1_1_1_1_1_1","31","3","1","27","0","22","19"
"NetworkManagementClient_1_1_1_1_1_1_1_1_1_1_1_1_1_1_1_1_1_1_1_1_1_1_1_1_1_1_1","0","0","0","0","0","1","1"
"NetworkManagementClient_1_1_1_1_1_1_1_1_1_1_1_1_1_1_1_1_1_1_1_1_1_1_1_1_1_1_1_1","0","0","0","0","0","1","1"
"NetworkManagementClient_1_1_1_1_1_1_1_1_1_1_1_1_1_1_1_1_1_1_1_1_1_1_1_1_1_1_1_1_1","6","1","2","3","0","5","4"
"NetworkManagementClient_1_1_1_1_1_1_1_1_1_1_1_1_1_1_1_1_1_1_1_1_1_1_1_1_1_1_1_1_1_1","6","1","2","3","0","5","4"
"NetworkManagementClient_1_1_1_1_1_1_1_1_1_1_1_1_1_1_1_1_1_1_1_1_1_1_1_1_1_1_1_1_1_1_1","6","1","2","3","0","5","4"
"NetworkManagementClient_1_1_1_1_1_1_1_1_1_1_1_1_1_1_1_1_1_1_1_1_1_1_1_1_1_1_1_1_1_1_1_1","6","1","2","3","0","5","4"
"NetworkManagementClient_1_1_1_1_1_1_1_1_1_1_1_1_1_1_1_1_1_1_1_1_1_1_1_1_1_1_1_1_1_1_1_1_1","6","1","2","3","0","5","4"
"NetworkManagementClient_1_1_1_1_1_1_1_1_1_1_1_1_1_1_1_1_1_1_1_1_1_1_1_1_1_1_1_1_1_1_1_1_1_1","6","1","2","3","0","5","4"
"NetworkManagementClient_1_1_1_1_1_1_1_1_1_1_1_1_1_1_1_1_1_1_1_1_1_1_1_1_1_1_1_1_1_1_1_1_1_1_1","6","1","2","3","0","5","4"
"NetworkManagementClient_1_1_1_1_1_1_1_1_1_1_1_1_1_1_1_1_1_1_1_1_1_1_1_1_1_1_1_1_1_1_1_1_1_1_1_1","6","1","2","3","0","5","4"
"NetworkManagementClient_1_1_1_1_1_1_1_1_1_1_1_1_1_1_1_1_1_1_1_1_1_1_1_1_1_1_1_1_1_1_1_1_1_1_1_1_1","10","2","2","6","0","9","7"
"NetworkManagementClient_1_1_1_1_1_1_1_1_1_1_1_1_1_1_1_1_1_1_1_1_1_1_1_1_1_1_1_1_1_1_1_1_1_1_1_1_1_1","10","2","2","6","0","9","7"
"NetworkManagementClient_1_1_1_1_1_1_1_1_1_1_1_1_1_1_1_1_1_1_1_1_1_1_1_1_1_1_1_1_1_1_1_1_1_1_1_1_1_1_1","10","2","2","6","0","9","7"
"NetworkManagementClient_1_1_1_1_1_1_1_1_1_1_1_1_1_1_1_1_1_1_1_1_1_1_1_1_1_1_1_1_1_1_1_1_1_1_1_1_1_1_1_1","10","2","2","6","0","9","7"
"NetworkManagementClient_1_1_1_1_1_1_1_1_1_1_1_1_1_1_1_1_1_1_1_1_1_1_1_1_1_1_1_1_1_1_1_1_1_1_1_1_1_1_1_1_1","10","2","2","6","0","9","7"
"NetworkManagementClient_1_1_1_1_1_1_1_1_1_1_1_1_1_1_1_1_1_1_1_1_1_1_1_1_1_1_1_1_1_1_1_1_1_1_1_1_1_1_1_1_1_1","10","2","2","6","0","9","7"
"NetworkManagementClient_1_1_1_1_1_1_1_1_1_1_1_1_1_1_1_1_1_1_1_1_1_1_1_1_1_1_1_1_1_1_1_1_1_1_1_1_1_1_1_1_1_1_1","10","2","2","6","0","9","7"
"NetworkManagementClient_1_1_1_1_1_1_1_1_1_1_1_1_1_1_1_1_1_1_1_1_1_1_1_1_1_1_1_1_1_1_1_1_1_1_1_1_1_1_1_1_1_1_1_1","10","2","2","6","0","9","7"
"NetworkManagementClient_1_1_1_1_1_1_1_1_1_1_1_1_1_1_1_1_1_1_1_1_1_1_1_1_1_1_1_1_1_1_1_1_1_1_1_1_1_1_1_1_1_1_1_1_1","10","2","2","6","0","9","7"
"NetworkManagementClient_1_1_1_1_1_1_1_1_1_1_1_1_1_1_1_1_1_1_1_1_1_1_1_1_1_1_1_1_1_1_1_1_1_1_1_1_1_1_1_1_1_1_1_1_1_1","10","2","2","6","0","9","7"
"NetworkManagementClient_1_1_1_1_1_1_1_1_1_1_1_1_1_1_1_1_1_1_1_1_1_1_1_1_1_1_1_1_1_1_1_1_1_1_1_1_1_1_1_1_1_1_1_1_1_1_1","10","2","2","6","0","9","7"
"NetworkManagementClient_1_1_1_1_1_1_1_1_1_1_1_1_1_1_1_1_1_1_1_1_1_1_1_1_1_1_1_1_1_1_1_1_1_1_1_1_1_1_1_1_1_1_1_1_1_1_1_1","10","2","2","6","0","9","7"
"NetworkManagementClient_1_1_1_1_1_1_1_1_1_1_1_1_1_1_1_1_1_1_1_1_1_1_1_1_1_1_1_1_1_1_1_1_1_1_1_1_1_1_1_1_1_1_1_1_1_1_1_1_1","10","2","2","6","0","9","7"
"NetworkManagementClient_1_1_1_1_1_1_1_1_1_1_1_1_1_1_1_1_1_1_1_1_1_1_1_1_1_1_1_1_1_1_1_1_1_1_1_1_1_1_1_1_1_1_1_1_1_1_1_1_1_1","10","2","2","6","0","9","7"
"NetworkManagementClient_1_1_1_1_1_1_1_1_1_1_1_1_1_1_1_1_1_1_1_1_1_1_1_1_1_1_1_1_1_1_1_1_1_1_1_1_1_1_1_1_1_1_1_1_1_1_1_1_1_1_1","0","0","0","0","0","1","1"
"NetworkManagementClient_1_1_1_1_1_1_1_1_1_1_1_1_1_1_1_1_1_1_1_1_1_1_1_1_1_1_1_1_1_1_1_1_1_1_1_1_1_1_1_1_1_1_1_1_1_1_1_1_1_1_1_1","0","0","0","0","0","1","1"
"NetworkManagementClient_1_1_1_1_1_1_1_1_1_1_1_1_1_1_1_1_1_1_1_1_1_1_1_1_1_1_1_1_1_1_1_1_1_1_1_1_1_1_1_1_1_1_1_1_1_1_1_1_1_1_1_1_1","0","0","0","0","0","1","1"
"NetworkManagementClient_1_1_1_1_1_1_1_1_1_1_1_1_1_1_1_1_1_1_1_1_1_1_1_1_1_1_1_1_1_1_1_1_1_1_1_1_1_1_1_1_1_1_1_1_1_1_1_1_1_1_1_1_1_1","0","0","0","0","0","1","1"
"NetworkManagementClient_1_1_1_1_1_1_1_1_1_1_1_1_1_1_1_1_1_1_1_1_1_1_1_1_1_1_1_1_1_1_1_1_1_1_1_1_1_1_1_1_1_1_1_1_1_1_1_1_1_1_1_1_1_1_1","0","0","0","0","0","1","1"
"NetworkManagementClient_1_1_1_1_1_1_1_1_1_1_1_1_1_1_1_1_1_1_1_1_1_1_1_1_1_1_1_1_1_1_1_1_1_1_1_1_1_1_1_1_1_1_1_1_1_1_1_1_1_1_1_1_1_1_1_1","0","0","0","0","0","1","1"
"NetworkManagementClient_1_1_1_1_1_1_1_1_1_1_1_1_1_1_1_1_1_1_1_1_1_1_1_1_1_1_1_1_1_1_1_1_1_1_1_1_1_1_1_1_1_1_1_1_1_1_1_1_1_1_1_1_1_1_1_1_1","0","0","0","0","0","1","1"
"NetworkManagementClient_1_1_1_1_1_1_1_1_1_1_1_1_1_1_1_1_1_1_1_1_1_1_1_1_1_1_1_1_1_1_1_1_1_1_1_1_1_1_1_1_1_1_1_1_1_1_1_1_1_1_1_1_1_1_1_1_1_1","0","0","0","0","0","1","1"
"NetworkManagementClient_1_1_1_1_1_1_1_1_1_1_1_1_1_1_1_1_1_1_1_1_1_1_1_1_1_1_1_1_1_1_1_1_1_1_1_1_1_1_1_1_1_1_1_1_1_1_1_1_1_1_1_1_1_1_1_1_1_1_1","0","0","0","0","0","1","1"
"NetworkManagementClient_1_1_1_1_1_1_1_1_1_1_1_1_1_1_1_1_1_1_1_1_1_1_1_1_1_1_1_1_1_1_1_1_1_1_1_1_1_1_1_1_1_1_1_1_1_1_1_1_1_1_1_1_1_1_1_1_1_1_1_1","0","0","0","0","0","1","1"
"NetworkManagementClient_1_1_1_1_1_1_1_1_1_1_1_1_1_1_1_1_1_1_1_1_1_1_1_1_1_1_1_1_1_1_1_1_1_1_1_1_1_1_1_1_1_1_1_1_1_1_1_1_1_1_1_1_1_1_1_1_1_1_1_1_1","0","0","0","0","0","1","1"
"NetworkManagementClient_1_1_1_1_1_1_1_1_1_1_1_1_1_1_1_1_1_1_1_1_1_1_1_1_1_1_1_1_1_1_1_1_1_1_1_1_1_1_1_1_1_1_1_1_1_1_1_1_1_1_1_1_1_1_1_1_1_1_1_1_1_1","0","0","0","0","0","1","1"
"NetworkManagementClient_1_1_1_1_1_1_1_1_1_1_1_1_1_1_1_1_1_1_1_1_1_1_1_1_1_1_1_1_1_1_1_1_1_1_1_1_1_1_1_1_1_1_1_1_1_1_1_1_1_1_1_1_1_1_1_1_1_1_1_1_1_1_1","0","0","0","0","0","1","1"
"NetworkManagementClient_1_1_1_1_1_1_1_1_1_1_1_1_1_1_1_1_1_1_1_1_1_1_1_1_1_1_1_1_1_1_1_1_1_1_1_1_1_1_1_1_1_1_1_1_1_1_1_1_1_1_1_1_1_1_1_1_1_1_1_1_1_1_1_1","0","0","0","0","0","1","1"
"NetworkManagementClient_1_1_1_1_1_1_1_1_1_1_1_1_1_1_1_1_1_1_1_1_1_1_1_1_1_1_1_1_1_1_1_1_1_1_1_1_1_1_1_1_1_1_1_1_1_1_1_1_1_1_1_1_1_1_1_1_1_1_1_1_1_1_1_1_1","18","3","0","15","0","17","14"
"NetworkManagementClient_1_1_1_1_1_1_1_1_1_1_1_1_1_1_1_1_1_1_1_1_1_1_1_1_1_1_1_1_1_1_1_1_1_1_1_1_1_1_1_1_1_1_1_1_1_1_1_1_1_1_1_1_1_1_1_1_1_1_1_1_1_1_1_1_1_1","24","3","0","21","0","20","17"
"NetworkManagementClient_1_1_1_1_1_1_1_1_1_1_1_1_1_1_1_1_1_1_1_1_1_1_1_1_1_1_1_1_1_1_1_1_1_1_1_1_1_1_1_1_1_1_1_1_1_1_1_1_1_1_1_1_1_1_1_1_1_1_1_1_1_1_1_1_1_1_1","24","3","0","21","0","20","17"
"NetworkManagementClient_1_1_1_1_1_1_1_1_1_1_1_1_1_1_1_1_1_1_1_1_1_1_1_1_1_1_1_1_1_1_1_1_1_1_1_1_1_1_1_1_1_1_1_1_1_1_1_1_1_1_1_1_1_1_1_1_1_1_1_1_1_1_1_1_1_1_1_1","24","3","0","21","0","20","17"
"NetworkManagementClient_1_1_1_1_1_1_1_1_1_1_1_1_1_1_1_1_1_1_1_1_1_1_1_1_1_1_1_1_1_1_1_1_1_1_1_1_1_1_1_1_1_1_1_1_1_1_1_1_1_1_1_1_1_1_1_1_1_1_1_1_1_1_1_1_1_1_1_1_1","24","3","0","21","0","22","19"
"NetworkManagementClient_1_1_1_1_1_1_1_1_1_1_1_1_1_1_1_1_1_1_1_1_1_1_1_1_1_1_1_1_1_1_1_1_1_1_1_1_1_1_1_1_1_1_1_1_1_1_1_1_1_1_1_1_1_1_1_1_1_1_1_1_1_1_1_1_1_1_1_1_1_1","28","3","0","25","0","23","20"
"NetworkManagementClient_1_1_1_1_1_1_1_1_1_1_1_1_1_1_1_1_1_1_1_1_1_1_1_1_1_1_1_1_1_1_1_1_1_1_1_1_1_1_1_1_1_1_1_1_1_1_1_1_1_1_1_1_1_1_1_1_1_1_1_1_1_1_1_1_1_1_1_1_1_1_1","28","3","0","25","0","25","22"
"NetworkManagementClient_1_1_1_1_1_1_1_1_1_1_1_1_1_1_1_1_1_1_1_1_1_1_1_1_1_1_1_1_1_1_1_1_1_1_1_1_1_1_1_1_1_1_1_1_1_1_1_1_1_1_1_1_1_1_1_1_1_1_1_1_1_1_1_1_1_1_1_1_1_1_1_1","28","3","0","25","0","25","22"
"NotificationHubsManagementClient","13","5","0","8","0","23","18"
"NotificationHubsManagementClient_1","11","4","0","7","0","24","20"
"NotificationHubsManagementClient_1_1","11","4","0","7","0","26","22"
"Azure Log Analytics - Operations Management","5","3","2","0","0","14","11"
"PostgreSQLManagementClient","18","4","0","14","0","25","21"
"PowerBIDedicated","8","3","0","5","0","10","7"
"Power BI Embedded Management Client","4","2","2","0","0","11","9"
"iotDpsClient","6","2","0","4","0","17","15"
"iotDpsClient_1","6","2","0","4","0","17","15"
"RedisManagementClient","6","2","0","4","0","8","6"
"RedisManagementClient_1","16","5","0","11","0","18","13"
"RedisManagementClient_1_1","19","6","0","13","0","22","16"
"RedisManagementClient_1_1_1","19","6","0","13","0","22","16"
"Relay","16","6","0","10","0","33","27"
"Relay_1","16","6","0","10","0","33","27"
"Azure Reservation","4","0","0","4","0","10","10"
"Microsoft.ResourceHealth","0","0","0","0","0","5","5"
"Microsoft.ResourceHealth_1","0","0","0","0","0","5","5"
"FeatureClient","0","0","0","0","0","4","4"
"ManagementLinkClient","4","1","0","3","0","5","4"
"ManagementLockClient","16","4","0","12","0","15","11"
"ManagedApplicationClient","16","4","0","12","0","15","11"
"ApplicationClient","16","4","0","12","0","15","11"
"Management Groups","0","0","0","0","0","3","3"
"PolicyClient","4","1","2","1","0","13","12"
"PolicyClient_1","4","1","2","1","0","13","12"
"PolicyClient_1_1","4","0","2","2","0","9","9"
"PolicyClient_1_1_1","6","0","4","2","0","9","9"
"PolicyClient_1_1_1_1","10","2","6","2","0","10","8"
"PolicyClient_1_1_1_1_1","14","2","6","6","0","10","8"
"SubscriptionClient","0","0","0","0","0","4","4"
"ResourceManagementClient","40","12","9","19","0","36","24"
"ResourceManagementClient_1","42","13","9","20","0","37","24"
"SearchManagementClient","4","1","0","3","0","5","4"
"SearchManagementClient_1","6","2","0","4","0","10","8"
"ServerManagement","26","5","2","19","0","22","17"
"ServerManagement_1","26","5","2","19","0","22","17"
"Service Map","1","1","0","0","0","25","24"
"ServiceBusManagementClient","18","7","0","11","0","38","31"
"ServiceBusManagementClient_1","16","7","0","9","0","37","30"
"ServiceBusManagementClient_1_1","23","11","0","12","0","54","43"
"ServiceFabricManagementClient","12","5","0","7","0","26","21"
"SqlManagementClient","0","0","0","0","0","3","3"
"SqlManagementClient_1","0","0","0","0","0","6","6"
"Azure SQL Database Backup Long Term Retention Policy","2","0","0","2","0","3","3"
"Azure SQL Server Backup Long Term Retention Vault","2","0","0","2","0","3","3"
"Azure SQL Database Backup","0","0","0","0","0","5","5"
"SqlManagementClient_1_1","2","0","0","2","0","2","2"
"SqlManagementClient_1_1_1","1","1","0","0","0","2","1"
"Azure SQL Database capabilities","0","0","0","0","0","1","1"
"SqlManagementClient_1_1_1_1","0","0","0","0","0","1","1"
"Azure SQL Server API spec","2","0","0","2","0","2","2"
"SqlManagementClient_1_1_1_1_1","0","0","0","0","0","1","1"
"SqlManagementClient_1_1_1_1_1_1","10","1","0","9","0","8","7"
"Database Threat Detection Policy APIs","2","0","0","2","0","2","2"
"Azure SQL Database Datamasking Policies and Rules","2","0","0","2","0","4","4"
"Azure SQL Database","0","0","0","0","0","2","2"
"SqlManagementClient_1_1_1_1_1_1_1","2","0","0","2","0","3","3"
"SqlManagementClient_1_1_1_1_1_1_1_1","8","1","0","7","0","6","5"
"Azure SQL Database server firewall rules","4","1","0","3","0","4","3"
"SqlManagementClient_1_1_1_1_1_1_1_1_1","6","1","0","5","0","5","4"
"Azure SQL Database_1","2","0","0","2","0","3","3"
"Azure SQL Database Import/Export spec","6","0","0","6","0","3","3"
"SqlManagementClient_1_1_1_1_1_1_1_1_1_1","6","2","0","4","0","5","3"
"Azure SQL Database_1_1","0","0","0","0","0","4","4"
"Azure SQL Database_1_1_1","0","0","0","0","0","1","1"
"SqlManagementClient_1_1_1_1_1_1_1_1_1_1_1","0","0","0","0","0","1","1"
"Azure SQL Database_1_1_1_1","0","0","0","0","0","3","3"
"SqlManagementClient_1_1_1_1_1_1_1_1_1_1_1_1","1","1","0","0","0","1","0"
"Azure SQL Database replication links","6","3","0","3","0","5","2"
"SqlManagementClient_1_1_1_1_1_1_1_1_1_1_1_1_1","0","0","0","0","0","1","1"
"Azure SQL Database API spec","4","0","0","4","0","4","4"
"Azure SQL Database_1_1_1_1_1","3","1","0","2","0","4","3"
"SqlManagementClient_1_1_1_1_1_1_1_1_1_1_1_1_1_1","6","2","0","4","0","5","3"
"SqlManagementClient_1_1_1_1_1_1_1_1_1_1_1_1_1_1_1","4","1","0","3","0","4","3"
"Azure SQL Database_1_1_1_1_1_1","4","1","0","3","0","5","4"
"SqlManagementClient_1_1_1_1_1_1_1_1_1_1_1_1_1_1_1_1","4","1","0","3","0","5","4"
"Azure SQL Database_1_1_1_1_1_1_1","0","0","0","0","0","2","2"
"Azure SQL Database_1_1_1_1_1_1_1_1","14","4","0","10","0","25","21"
"SqlManagementClient_1_1_1_1_1_1_1_1_1_1_1_1_1_1_1_1_1","4","1","0","3","0","6","5"
"SqlManagementClient_1_1_1_1_1_1_1_1_1_1_1_1_1_1_1_1_1_1","8","4","0","4","0","10","6"
"SqlManagementClient_1_1_1_1_1_1_1_1_1_1_1_1_1_1_1_1_1_1_1","6","2","0","4","0","6","4"
"SqlManagementClient_1_1_1_1_1_1_1_1_1_1_1_1_1_1_1_1_1_1_1_1","6","0","0","6","0","8","8"
"Azure SQL Database_1_1_1_1_1_1_1_1_1","0","0","0","0","0","2","2"
"SqlManagementClient_1_1_1_1_1_1_1_1_1_1_1_1_1_1_1_1_1_1_1_1_1","0","0","0","0","0","2","2"
"SqlManagementClient_1_1_1_1_1_1_1_1_1_1_1_1_1_1_1_1_1_1_1_1_1_1","0","0","0","0","0","2","2"
"SqlManagementClient_1_1_1_1_1_1_1_1_1_1_1_1_1_1_1_1_1_1_1_1_1_1_1","4","1","0","3","0","4","3"
"StorageManagementClient","4","1","0","3","0","9","8"
"StorageManagement","4","1","0","3","0","9","8"
"StorageManagementClient_1","4","1","0","3","0","9","8"
"StorageManagement_1","4","1","0","3","0","11","10"
"StorageManagement_1_1","4","1","0","3","0","11","10"
"StorageManagement_1_1_1","4","1","0","3","0","13","12"
"StorageManagement_1_1_1_1","4","1","0","3","0","13","12"
"StorageImportExport","5","1","2","2","0","9","8"
"SubscriptionDefinitionsClient","4","0","0","4","0","5","5"
"TimeSeriesInsightsClient","16","4","0","12","0","18","14"
"TimeSeriesInsightsClient_1","16","4","0","12","0","18","14"
"Visual Studio Resource Provider Client","6","2","0","4","0","14","12"
"Visual Studio Resource Provider Client_1","4","2","0","2","0","13","11"
"WebSite Management Client","112","3","75","34","0","279","276"
"Radio & Music Services","8","8","0","0","0","75","67"
"BBC Nitro","51","2","49","0","0","25","23"
"BBC iPlayer Business Layer","5","0","5","0","0","30","31"
"BC Laws","7","7","0","0","0","7","0"
"Beanstream Payments","0","0","0","0","0","15","15"
"BeezUP","284","83","201","0","0","179","96"
"Betfair: Exchange Streaming","1","1","0","0","0","1","0"
"BigOven","18","4","14","0","0","63","59"
"BikeWise API v2","4","4","0","0","0","4","0"
"Bitbucket","80","73","3","4","0","182","193"
"Blazemeter API Explorer","0","0","0","0","0","14","14"
"IBM Containers","20","17","3","0","0","46","29"
"Botify","14","0","14","0","0","29","29"
"Box 2.0 Authorization","1","1","0","0","0","1","0"
"Box 2.0","43","23","10","10","0","127","104"
"Box 2.0 OAuth2 Token","1","1","0","0","0","2","1"
"Box 2.0 Uploads","3","1","0","2","0","9","8"
"BrandLovers Marketplace API V1","19","19","0","0","0","36","17"
"Browshot","3","2","1","0","0","17","15"
"Bufferapp","1","0","1","0","0","18","18"
"Bungie.Net","53","0","53","0","0","94","94"
"CallFire","40","35","3","2","0","111","76"
"Cambase.io","14","14","0","0","0","14","0"
"EVE Swagger Interface","21","21","0","0","0","203","182"
"Cenit IO - REST API Specification","13","10","3","0","0","40","60"
"Channel 4","68","68","0","0","0","68","0"
"CircleCI","42","2","39","0","1","22","20"
"REST API Version 2","10","9","1","0","0","52","43"
"Cisco PSIRT openVuln","19","19","0","0","0","19","0"
"SCIM","2","2","0","0","0","14","12"
"City Context","3","0","3","0","0","3","3"
"Clarify","31","21","0","10","0","21","0"
"Clever-Cloud","180","176","4","0","0","274","98"
"ClickMeter","6","0","6","0","0","108","108"
"Discovery Market Research","5","5","0","0","0","5","0"
"Cnab Online","0","0","0","0","0","4","4"
"The Consumer Financial Protection Bureau","5","5","0","0","0","6","1"
"CORE API v2","2","1","1","0","0","17","16"
"EU BON UTIS","0","0","0","0","0","2","2"
"Regulations.gov","3","3","0","0","0","3","0"
"Data2CRM.API","18","14","4","0","0","95","81"
"Open Skills","0","0","0","0","0","13","13"
"DatumBox","14","14","0","0","0","14","0"
"Betriebsstellen","0","0","0","0","0","2","2"
"Fahrplan-Free","0","0","0","0","0","4","4"
"FaSta-Station_Facilities_Status","0","0","0","0","0","5","5"
"Flinkster_API_NG","0","0","0","0","0","10","10"
"Reisezentren-API","0","0","0","0","0","4","4"
"Stationsdatenbereitstellung","0","0","0","0","0","4","4"
"DocuSign","48","48","0","0","0","303","255"
"domainsdb.info","0","0","0","0","0","1","1"
"DropX","7","7","0","0","0","7","0"
"dweet.io","13","13","0","0","0","13","0"
"API to View & Search for Items","0","0","0","0","0","4","4"
"Item Feed Service","4","0","0","4","0","2","2"
"Buy Marketing","4","0","0","4","0","3","3"
"Taxonomy","6","0","0","6","0","5","5"
"Fulfillment","1","0","1","0","0","5","5"
"U.S. EPA Enforcement and Compliance History Online (ECHO) - Enforcement Case Search","2","2","0","0","0","16","14"
"U.S. EPA Enforcement and Compliance History Online (ECHO) - Detailed Facility Report (DFR)","0","0","0","0","0","68","68"
"U.S. EPA Enforcement and Compliance History Online (ECHO) - Effluent Charting and Reporting","2","2","0","0","0","8","6"
"REST API v1 Core Resources","27","27","0","0","0","27","0"
"Europeana","3","2","1","0","0","13","11"
"ExaVault","0","0","0","0","0","35","35"
"Figshare","57","34","23","0","0","111","77"
"FireBrowse Beta API","30","30","0","0","0","30","0"
"Flat","12","11","1","0","0","60","49"
"Freesound","0","0","0","0","0","2","2"
"FunTranslations","36","36","0","0","0","36","0"
"Furkot Trips","0","0","0","0","0","2","2"
"Geneea Natural Language Processing","15","0","5","10","0","11","11"
"RAMADDA","229","229","0","0","0","229","0"
"GoToTraining","6","6","0","0","0","22","16"
"GoToWebinar","8","8","0","0","0","38","30"
"Sandbox","3","3","0","0","0","9","6"
"Getty Images","10","5","5","0","0","42","37"
"Giphy","20","0","20","0","0","10","10"
"Gisgraphy webservices","0","0","0","0","0","6","6"
"GitHub","79","66","4","2","7","226","160"
"Gitlab","87","87","0","0","0","358","542"
"Google Abusive Experience Report","0","0","0","0","0","2","2"
"Accelerated Mobile Pages (AMP) URL","0","0","0","0","0","1","1"
"Ad Exchange Buyer","0","0","0","0","0","6","6"
"Ad Exchange Buyer_1","5","1","4","0","0","18","17"
"Ad Exchange Buyer_1_1","9","5","4","0","0","34","29"
"Ad Exchange Buyer API II","5","0","5","0","0","33","33"
"Ad Exchange Seller","0","0","0","0","0","17","17"
"Ad Exchange Seller_1","0","0","0","0","0","11","11"
"Ad Exchange Seller_1_1","0","0","0","0","0","14","14"
"Google Ad Experience Report","0","0","0","0","0","2","2"
"Admin Data Transfer","0","0","0","0","0","5","5"
"Admin Directory","61","28","33","0","0","100","72"
"Admin Reports","1","1","0","0","0","6","5"
"AdSense Management","0","0","0","0","0","34","34"
"AdSense Management_1","2","2","0","0","0","38","36"
"AdSense Host","0","0","0","0","0","24","24"
"Google Analytics","6","6","0","0","0","6","0"
"Google Analytics_1","10","10","0","0","0","75","65"
"Google Analytics Reporting","0","0","0","0","0","1","1"
"Android Device Provisioning Partner","5","0","5","0","0","20","20"
"Google Play EMM","15","15","0","0","0","75","60"
"Android Management","3","0","3","0","0","10","10"
"Google Play Developer","1","1","0","0","0","3","2"
"Google Play Developer_1","1","1","0","0","0","2","1"
"Google Play Developer_1_1","10","10","0","0","0","49","39"
"Google App Engine Admin","3","0","3","0","0","32","32"
"Google App Engine Admin_1","1","0","1","0","0","13","13"
"Google App Engine Admin_1_1","3","0","3","0","0","32","32"
"Google App Engine Admin_1_1_1","0","0","0","0","0","17","17"
"Google App Engine Admin_1_1_1_1","0","0","0","0","0","17","17"
"G Suite Activity","0","0","0","0","0","1","1"
"Google App State","1","1","0","0","0","5","4"
"BigQuery","3","2","1","0","0","20","18"
"BigQuery Data Transfer","2","0","2","0","0","10","10"
"Blogger","0","0","0","0","0","9","9"
"Blogger_1","3","3","0","0","0","31","28"
"Books","13","11","2","0","0","51","40"
"Calendar","6","6","0","0","0","33","27"
"Google Civic Information","0","0","0","0","0","5","5"
"Google Classroom","16","0","16","0","0","48","48"
"Google Cloud Billing","0","0","0","0","0","7","7"
"Google Cloud Container Builder","5","0","5","0","0","12","12"
"Stackdriver Debugger","2","0","2","0","0","8","8"
"Stackdriver Error Reporting","2","0","2","0","0","6","6"
"Google Cloud Functions","3","0","3","0","0","9","9"
"Google Cloud Functions_1","3","0","3","0","0","10","10"
"Google Cloud IoT","2","0","2","0","0","12","12"
"Google Cloud IoT_1","2","0","2","0","0","11","11"
"Google Cloud Key Management Service (KMS)","2","0","2","0","0","16","16"
"Cloud Monitoring","0","0","0","0","0","6","6"
"Google Cloud Resource Manager","11","0","11","0","0","24","24"
"Google Cloud Resource Manager_1","6","0","6","0","0","16","16"
"Google Cloud Resource Manager_1_1","2","0","2","0","0","10","10"
"Cloud Tasks","8","0","8","0","0","18","18"
"Stackdriver Trace","0","0","0","0","0","2","2"
"Stackdriver Trace_1","1","0","1","0","0","2","2"
"Cloud User Accounts","1","1","0","0","0","23","22"
"Cloud User Accounts_1","1","1","0","0","0","17","16"
"Cloud User Accounts_1_1","1","1","0","0","0","23","22"
"Cloud User Accounts_1_1_1","1","1","0","0","0","17","16"
"Compute Engine","3","3","0","0","0","451","448"
"Compute Engine_1","3","3","0","0","0","368","365"
"Compute Engine_1_1","3","3","0","0","0","290","287"
"Consumer Surveys","0","0","0","0","0","11","11"
"Google Container Engine","5","0","5","0","0","30","30"
"Google Container Engine_1","2","0","2","0","0","54","54"
"Content API for Shopping","3","3","0","0","0","56","53"
"Content API for Shopping_1","0","0","0","0","0","17","17"
"CustomSearch","0","0","0","0","0","2","2"
"Google Dataflow","18","0","18","0","0","29","29"
"Google Cloud Dataproc","5","0","5","0","0","13","13"
"Google Cloud Dataproc_1","4","0","4","0","0","12","12"
"Google Cloud Dataproc_1_1","6","0","6","0","0","13","13"
"Google Cloud Dataproc_1_1_1","5","0","5","0","0","20","20"
"Google Cloud Datastore","5","0","5","0","0","11","11"
"Google Cloud Datastore_1","0","0","0","0","0","2","2"
"Google Cloud Datastore_1_1","3","0","3","0","0","7","7"
"Google Cloud Deployment Manager Alpha","0","0","0","0","0","33","33"
"Google Cloud Deployment Manager","0","0","0","0","0","17","17"
"Google Cloud Deployment Manager API V2Beta Methods","0","0","0","0","0","29","29"
"DCM/DFA Reporting And Trafficking","11","11","0","0","0","178","167"
"DCM/DFA Reporting And Trafficking_1","11","11","0","0","0","179","168"
"DCM/DFA Reporting And Trafficking_1_1","10","10","0","0","0","178","168"
"APIs Discovery Service","0","0","0","0","0","2","2"
"DLP","9","0","9","0","0","11","11"
"Google Cloud DNS","1","1","0","0","0","9","8"
"Google Cloud DNS_1","0","0","0","0","0","14","14"
"Google Cloud DNS_1_1","0","0","0","0","0","14","14"
"DoubleClick Bid Manager","2","2","0","0","0","9","7"
"DoubleClick Search","3","1","2","0","0","9","8"
"Drive","14","14","0","0","0","61","47"
"Drive_1","9","9","0","0","0","33","24"
"Firebase Dynamic Links","0","0","0","0","0","3","3"
"Firebase Remote Config","0","0","0","0","0","2","2"
"Firebase Rules","8","0","8","0","0","9","9"
"Fitness","2","2","0","0","0","12","10"
"Fusion Tables","6","5","1","0","0","28","23"
"Fusion Tables_1","6","5","1","0","0","30","25"
"Google Play Game Services","7","7","0","0","0","53","46"
"Google Play Game Services Publishing","2","2","0","0","0","11","9"
"Google Play Game Services Management","22","22","0","0","0","27","5"
"Genomics","12","0","12","0","0","48","48"
"Genomics_1","4","0","4","0","0","9","9"
"Gmail","13","13","0","0","0","60","47"
"Groups Migration","0","0","0","0","0","1","1"
"Groups Settings","0","0","0","0","0","2","2"
"Google Identity and Access Management (IAM)","0","0","0","0","0","18","18"
"Google Identity Toolkit","0","0","0","0","0","20","20"
"Knowledge Graph Search","3","0","3","0","0","1","1"
"Google Cloud Natural Language","0","0","0","0","0","6","6"
"Google Cloud Natural Language_1","0","0","0","0","0","6","6"
"Enterprise License Manager","1","1","0","0","0","6","5"
"Stackdriver Logging","5","0","5","0","0","19","19"
"Stackdriver Logging_1","4","0","4","0","0","15","15"
"Manufacturer Center","1","0","1","0","0","4","4"
"Google Mirror","4","4","0","0","0","22","18"
"Google Cloud Machine Learning Engine","3","0","3","0","0","17","17"
"Google Cloud Machine Learning Engine_1","4","0","4","0","0","16","16"
"Stackdriver Monitoring","2","0","2","0","0","15","15"
"Google OAuth2","0","0","0","0","0","8","8"
"Google OAuth2_1","0","0","0","0","0","4","4"
"Google Cloud OS Login","1","0","1","0","0","4","4"
"Google Cloud OS Login_1","1","0","1","0","0","4","4"
"Google Cloud OS Login_1_1","1","0","1","0","0","4","4"
"PageSpeed Insights","0","0","0","0","0","1","1"
"PageSpeed Insights_1","0","0","0","0","0","1","1"
"Google Partners","1","0","1","0","0","15","15"
"Google People","2","0","2","0","0","11","11"
"Google Play Custom App Publishing","0","0","0","0","0","1","1"
"Google Play Movies Partner","0","0","0","0","0","6","6"
"Google+","0","0","0","0","0","9","9"
"Google+ Domains","2","2","0","0","0","19","17"
"Poly","0","0","0","0","0","4","4"
"Prediction","3","1","2","0","0","6","5"
"Prediction_1","3","1","2","0","0","6","5"
"Prediction_1_1","3","1","2","0","0","6","5"
"Prediction_1_1_1","4","1","3","0","0","8","7"
"Prediction_1_1_1_1","3","1","2","0","0","8","7"
"Google Proximity Beacon","5","0","5","0","0","17","17"
"Google Cloud Pub/Sub","7","0","7","0","0","20","20"
"Google Cloud Pub/Sub_1","6","0","6","0","0","15","15"
"Google Cloud Pub/Sub_1_1","5","0","5","0","0","16","16"
"QPX Express","0","0","0","0","0","1","1"
"Replica Pool","2","2","0","0","0","10","8"
"Google Compute Engine Instance Group Manager","0","0","0","0","0","12","12"
"Google Compute Engine Instance Group Updater","0","0","0","0","0","10","10"
"Enterprise Apps Reseller","1","1","0","0","0","16","15"
"Resource Views","6","6","0","0","0","14","8"
"Google Compute Engine Instance Groups","0","0","0","0","0","11","11"
"Google Cloud Runtime Configuration","3","0","3","0","0","3","3"
"Google Cloud Runtime Configuration_1","1","0","1","0","0","13","13"
"Google Safe Browsing","1","0","1","0","0","7","7"
"Google Apps Script","1","0","1","0","0","1","1"
"Google Search Console URL Testing Tools","0","0","0","0","0","1","1"
"Service Consumer Management","2","0","2","0","0","8","8"
"Google Service Control","0","0","0","0","0","6","6"
"Google Service Management","3","0","3","0","0","21","21"
"Google Service User","2","0","2","0","0","4","4"
"Google Sheets","3","0","3","0","0","17","17"
"Google Site Verification","1","1","0","0","0","6","5"
"Google Slides","0","0","0","0","0","5","5"
"Cloud Source Repositories","1","0","1","0","0","7","7"
"Cloud Spanner","13","0","13","0","0","22","22"
"Google Spectrum Database","0","0","0","0","0","6","6"
"Google Cloud Speech","3","0","3","0","0","6","6"
"Google Cloud Speech_1","2","0","2","0","0","6","6"
"Cloud SQL Administration","0","0","0","0","0","23","23"
"Cloud SQL Administration_1","0","0","0","0","0","39","39"
"Cloud Storage","9","7","2","0","0","42","35"
"Cloud Storage_1","4","4","0","0","0","20","16"
"Cloud Storage_1_1","7","6","1","0","0","29","23"
"Google Storage Transfer","6","0","6","0","0","9","9"
"Street View Publish","2","0","2","0","0","9","9"
"Surveys","0","0","0","0","0","11","11"
"Tag Manager","9","9","0","0","0","49","40"
"TaskQueue","1","1","0","0","0","5","4"
"TaskQueue_1","1","1","0","0","0","7","6"
"Tasks","3","3","0","0","0","12","9"
"Google Cloud Testing","4","0","4","0","0","4","4"
"Cloud Tool Results","0","0","0","0","0","22","22"
"Cloud Tool Results firstparty","0","0","0","0","0","22","22"
"Cloud TPU","2","0","2","0","0","9","9"
"Stackdriver Trace_1_1","1","0","1","0","0","4","4"
"Google Cloud Translation","0","0","0","0","0","5","5"
"URL Shortener","0","0","0","0","0","3","3"
"Google Vault","6","0","6","0","0","18","18"
"Cloud Video Intelligence","0","0","0","0","0","1","1"
"Google Cloud Vision","0","0","0","0","0","1","1"
"Google Cloud Vision_1","0","0","0","0","0","1","1"
"Google Fonts Developer","0","0","0","0","0","1","1"
"Search Console","5","5","0","0","0","13","8"
"YouTube Data","39","19","20","0","0","72","53"
"YouTube Analytics","3","2","1","0","0","8","6"
"YouTube Analytics_1","3","2","1","0","0","8","6"
"YouTube Reporting","1","0","1","0","0","8","8"
"BC Data Catalogue","22","22","0","0","0","22","0"
"BC Geographical Names Web Service -","14","14","0","0","0","14","0"
"Geocoder","15","15","0","0","0","15","0"
"GeoMark Web Service","7","7","0","0","0","7","0"
"WorkBC Job Posting","0","0","0","0","0","5","5"
"DriveBC's Open511","4","4","0","0","0","4","0"
"BC Route Planner","4","4","0","0","0","4","0"
"Route Optimization","0","0","0","0","0","2","2"
"Metadata","36","36","0","0","0","36","0"
"Profile","3","3","0","0","0","3","0"
"Stats","28","28","0","0","0","28","0"
"UGC","4","4","0","0","0","4","0"
"HHS Media Services","5","3","2","0","0","32","29"
"Icons8","1","0","1","0","0","7","7"
"Active Documentation for /v1","16","15","0","1","0","15","0"
"Mailsquad","6","5","1","0","0","8","3"
"Infermedica","1","0","1","0","0","9","9"
"Instagram","0","0","0","0","0","27","27"
"Instawell","0","0","0","0","0","8","8"
"API iSendPro","2","2","0","0","0","11","9"
"Entertainment Express","261","0","29","232","0","116","232"
"Jirafe Events","6","6","0","0","0","6","0"
"Jumpseller API","0","0","0","0","0","95","95"
"koomalooma Partner","0","0","0","0","0","2","2"
"LaunchDarkly","13","10","3","0","0","27","17"
"link.fish","1","1","0","0","0","6","5"
"LotaData","2","0","2","0","0","4","4"
"Lyft","18","4","14","0","0","16","12"
"Magento Enterprise","141","1","140","0","0","355","354"
"Tradeworks","8","8","0","0","0","8","0"
"Mandrill","16","1","0","0","15","90","89"
"Geo DB","0","0","0","0","0","16","16"
"Rat Genome Database","1","0","1","0","0","56","56"
"Medium.com","0","0","0","0","0","5","5"
"Custom Search","0","0","0","0","0","1","1"
"Entity Search","0","0","0","0","0","1","1"
"Image Search","0","0","0","0","0","3","3"
"News Search","0","0","0","0","0","3","3"
"Spell Check","0","0","0","0","0","1","1"
"Video Search","0","0","0","0","0","3","3"
"Web Search","0","0","0","0","0","1","1"
"Moon by Ai Weiwei & Olafur Eliasson","2","2","0","0","0","2","0"
"MotaWord","9","0","7","2","0","47","47"
"Native Ads Publisher","0","0","0","0","0","4","4"
"Advicent.FactFinderService","29","16","5","8","0","129","113"
"Published Plan Service","19","7","12","0","0","51","44"
"NBA Stats","91","91","0","0","0","91","0"
"NeoWs - (Near Earth Object Web Service)","3","0","3","0","0","5","5"
"Netatmo","1","0","1","0","0","20","20"
"NeutrinoAPI","0","0","0","0","0","26","52"
"nFusion Solutions Market Data API v1","0","0","0","0","0","14","14"
"NPR One API Reference","29","2","22","2","3","23","21"
"High Performance Building Database","2","2","0","0","0","2","0"
"Transportation Laws and Incentives","4","0","4","0","0","4","4"
"NSIDC Web Service Documentation Index","4","4","0","0","0","4","0"
"Archive","1","0","1","0","0","1","1"
"Article Search","1","0","1","0","0","1","1"
"Books_1","2","0","1","0","1","6","6"
"Community","20","0","4","0","16","4","4"
"Most Popular","7","0","7","0","0","3","3"
"Movie Reviews","0","0","0","0","0","3","3"
"Semantic","0","0","0","0","0","2","2"
"TimesTags","0","0","0","0","0","1","1"
"Times Newswire","0","0","0","0","0","3","3"
"Top Stories","0","0","0","0","0","1","1"
"Mobility","2","0","0","2","0","2","2"
"Socio-demo","4","0","0","4","0","3","3"
"ODWeather","8","8","0","0","0","8","0"
"OMDb","0","0","0","0","0","1","1"
"Swagger2OpenAPI Converter","6","1","5","0","0","6","5"
"Open Data","12","12","0","0","0","12","0"
"OpenCage Geocoder","2","0","2","0","0","1","1"
"OpenFinTech.io","16","16","0","0","0","16","0"
"OrgHunter","6","6","0","0","0","6","0"
"OSF APIv2 Documentation","22","18","4","0","0","103","85"
"Owler","1","0","1","0","0","12","12"
"Pandorabots AIaaS","13","13","0","0","0","13","0"
"PasswordUtility.Web","2","0","2","0","0","2","2"
"PatientView","12","4","2","6","0","15","11"
"Paylocity","532","9","523","0","0","18","9"
"PayRun.IO","146","146","0","0","0","248","102"
"Peel Tune-in API","5","5","0","0","0","5","0"
"Polygon","0","0","0","0","0","10","10"
"Postmark Account-level","1","1","0","0","0","20","19"
"Postmark","9","0","9","0","0","49","49"
"posty_API","28","28","0","0","0","28","0"
"Qualpay Payment Gateway","0","0","0","0","0","10","10"
"Request Baskets","8","4","0","4","0","9","5"
"Refuge Restrooms","4","4","0","0","0","4","0"
"reverb","158","158","0","0","0","158","0"
"Ritc","40","10","30","0","0","58","48"
"RiteKit","13","13","0","0","0","13","0"
"Rotten Tomatoes","18","18","0","0","0","18","0"
"Seldon","15","15","0","0","0","15","0"
"Runscope","23","15","8","0","0","29","14"
"SalesLoft Platform","10","6","4","0","0","52","46"
"SchoolDigger API V1","0","0","0","0","0","6","6"
"Scrape Website Email API","3","3","0","0","0","3","0"
"SelectPdf HTML To PDF","1","1","0","0","0","1","0"
"Semantria","88","9","22","57","0","41","32"
"ShipStation Developer Portal","51","51","0","0","0","51","0"
"SlideRoom API V2","0","0","0","0","0","11","11"
"smart-me","5","2","3","0","0","32","30"
"Solar VPS","20","20","0","0","0","20","0"
"SpectroCoin Merchant","0","0","0","0","0","1","1"
"Article Rewriter and Article Extractor","4","3","1","0","0","4","1"
"Square Connect","1","0","1","0","0","96","96"
"api.ecota.co v2","27","27","0","0","0","27","0"
"StatSocial Platform","1","0","1","0","0","17","17"
"Storecove","2","2","0","0","0","12","10"
"Stripe","47","0","47","0","0","192","192"
"Swagger Generator","2","1","1","0","0","7","6"
"SwaggerHub Registry","18","10","6","2","0","22","12"
"SYNQ Video","6","2","4","0","0","7","5"
"taggun.io","16","0","16","0","0","10","10"
"Taxamo","0","0","0","0","0","36","36"
"Taxrates.io","0","0","0","0","0","6","6"
"Transport for London Unified","9","0","9","0","0","84","84"
"The Noun Project","13","13","0","0","0","13","0"
"The SMS Works","12","12","0","0","0","12","0"
"TheTVDB API v2","2","1","1","0","0","30","29"
"Airports API v2","0","0","0","0","0","5","10"
"Trello","324","324","0","0","0","324","0"
"Twilio","149","116","0","33","0","116","0"
"Twine","49","49","0","0","0","49","0"
"uebermaps API endpoints","1","0","1","0","0","49","49"
"VAT API","2","2","0","0","0","11","9"
"Available API endpoints","46","46","0","0","0","46","0"
"Vestorly","0","0","0","0","0","33","33"
"VictorOps","9","3","6","0","0","41","38"
"VisageCloud","51","2","1","48","0","46","44"
"Voodoo Manufacturing","0","0","0","0","0","11","11"
"CitySDK Linked Data","41","41","0","0","0","41","0"
"Wavecell.Sms.Api","7","1","0","6","0","4","3"
"Wealthport","15","13","0","2","0","26","26"
"Weatherbit.io - Weather","1","1","0","0","0","51","50"
"Accounts","0","0","0","0","0","5","5"
"Bets","6","0","0","6","0","6","6"
"Locations","0","0","0","0","0","5","5"
"Numbers","0","0","0","0","0","1","1"
"Sessions","0","0","0","0","0","4","4"
"SportsData","0","0","0","0","0","13","13"
"Wikimedia","4","3","1","0","0","28","25"
"BatchService","44","44","0","0","0","67","23"
"BatchService_1","44","44","0","0","0","70","26"
"BatchService_1_1","45","45","0","0","0","71","26"
"BatchService_1_1_1","45","45","0","0","0","71","26"
"BatchService_1_1_1_1","45","45","0","0","0","71","26"
"BatchService_1_1_1_1_1","45","45","0","0","0","72","27"
"BatchService_1_1_1_1_1_1","45","45","0","0","0","72","27"
"GraphRbacManagementClient","7","7","0","0","0","33","26"
"Winning Email","2","0","2","0","0","3","3"
"Real-Time Bus Predictions","2","2","0","0","0","2","0"
"Bus Route and Stop Methods","12","12","0","0","0","12","0"
"Incidents","6","6","0","0","0","6","0"
"Real-Time Rail Predictions","2","2","0","0","0","2","0"
"Rail Station Information","16","16","0","0","0","16","0"
"Word Associations","0","0","0","0","0","2","2"
"Wordnik","4","4","0","0","0","28","24"
"Transform","2","2","0","0","0","2","0"
"Accounting","20","18","2","0","0","151","133"
"XKCD","0","0","0","0","0","2","2"
"Yunbi","22","22","0","0","0","22","0"
"Zappiti Player","0","0","0","0","0","7","7"
"Zoom Connect","58","13","0","45","0","49","36"
"Zuora API Reference","309","309","0","0","0","313","4"
"APIs.guru_1","0","0","0","0","0","2","2"
